Anyone can do that.	任何人都可以甘做。 
How about another piece of cake?	再黎一块蛋糕点啊？ 
She married him.	佢嫁左比佢。 
I don't like learning irregular verbs.	我唔中意学唔规则动字。 
It's a whole new ball game for me.	对我黎讲尼一场啦，全新的比赛。 
He's sleeping like a baby.	佢训到成个苏虾仔。 
He can play both tennis and baseball.	佢会打网球同棒球。 
We should cancel the hike.	我地应该取消远足。 
He is good at dealing with children.	佢善于同仔们打交道。 
She will do her best to be here on time.	佢会尽最大的努力准时到尼度。 
Why are you so good at cooking?	你点解甘识煮饭？ 
He has recovered from his bad cold.	佢重感冒已经好翻晒。 
It's a dead end.	里个倔头路。 
I rejected the offer.	我拒绝左尼个好提议.. 
He often quotes Milton.	佢成日引用弥尔顿的野。 
Mommy, may I go swimming?	妈咪，我可以去游水吗？ 
Miyazaki is not what it used to be.	宫崎骏已经今时唔同往日啦。 
People must love one another.	的人要大家相爱。 
Where do you have pain?	你边度痛呀？ 
Keep oil away from the fire.	比油远离火。 
This is never going to end.	尼永远唔会搞掂。 
He had a hungry look.	佢一面饥渴。 
I don't know which button to push.	我唔知按边个按钮。 
He heard the news on the radio.	佢系部收音机度听到尼个消息。 
Don't leave the water running.	唔好比水一流住。 
I'm opposed to any type of war.	我唔比任何形式的战争。 
I had a hard day.	我今日过得好辛苦。 
He will succeed to the throne.	佢将继承王位。 
Please give me something hot to drink.	唔该比我的热饮料。 
Have fun.	玩得开心。 
The library is on the second floor.	图书馆系二楼。 
Look at me with your books closed.	望住我合埋你的书。 
I still love him.	我仍然爱佢。 
His low salary prevents him from buying the house.	佢低工资令佢买唔起屋。 
Hang your coat on the hook.	将你的外套挂系钩上。 
I can't understand his feelings.	我无法理解佢感受。 
She didn't try to hide the truth.	佢冇试图隐瞒真相。 
Dad bought me a camera.	爸爸比我买左部相机。 
I love her and she loves me.	我钟意佢，佢都钟意我。 
The boy has learned to read.	尼个男仔学识左体书。 
You are irresistible.	你系唔可抗拒的。 
It was heartless of him to say such a thing to the sick man.	佢对病人讲的甘的野真系倔情。 
He calls her up every night.	佢晚晚都比佢打左电话。 
They left one after another.	佢地一个接一个甘走左。 
Father always has the tailor make his suits.	老豆系比裁缝比佢做西装。 
We got him to carry our bag.	我地比佢帮我地罗包。 
He drove the truck to Dallas.	佢开住货车去左达拉斯。 
The baby smiled at me.	宝宝对我笑笑口。 
Did he propose to you?	佢同你求婚？ 
Cheese is made from milk.	芝士系由牛奶做。 
I help my mother with the housework every day.	我每日同妈咪做家务。 
I spoke with him about the matter.	我同佢倾左尼件事。 
The friend who I thought would pass the exam failed it.	我以为会通过考试果个朋友考试失败左。 
They are very big apples.	佢地系好大个苹果。 
How dare you!	好大的胆！ 
He must have taken the wrong train.	佢一定系坐错火车啦。 
I understand how to solve the problem.	我知点解决尼个问题。 
How many children do you have?	你有几个仔？ 
He no longer lives here.	佢唔再住系尼度。 
He is the same age as me.	佢同我同岁。 
Industry as we know it today didn't exist in those days.	我地今日所知的工业系果的日子企唔存在。 
That boy used to drop in on me.	个男仔过去常黎探我。 
I think you'll have very little difficulty in getting a driver's license.	我想你罗去找唔会有咩困难。 
Run.	走呀。 
He told me to do it, so I did it.	佢叫我做尼件事，我就做左。 
That is not my line.	甘唔系我台词。 
She lives in a large house.	佢系一间大屋。 
A doctor told me that eating eggs was bad for me.	医生，话比我食鸡蛋对我唔好。 
She asked him to open the window.	佢比佢打开窗。 
She has a flower in her hand.	佢手里罗住一朵花。 
I have just finished my homework.	我刚刚做埋工作。 
You look pale today.	你今日面青青。 
I'm counting how many people there are.	我系数有几多人。 
I felt that my honor was at stake.	我觉得我荣誉岌岌可危。 
Money isn't the only thing that matters.	有钱唔系唯重要的野。 
Tom just never should've done that.	阿Tom，根本就唔应该甘做。 
I don't want there to be any misunderstanding.	我唔想有任何误会。 
He may not be happy.	佢可能唔开心。 
The hunter shot the fox dead.	猎人将狐狸打死。 
He goes to school to study every day.	佢日日都去学校学习。 
I spent last Sunday reading a novel.	上个礼拜日我读左一本小说。 
Mary closed the door quietly.	阿Mary静鸡鸡关度门。 
You smoke far too much. You should cut back.	你食烟太多啦。 你应该削减使用。 
I wish I could have spoken Spanish.	我希望我会讲讲西班牙文。 
There's nothing I wouldn't do for Tom.	为左阿Tom我咩都肯做。 
Tom was making French fries.	阿Tom系度做炸薯条。 
I study for 3 hours every day.	我每日学习3个钟。 
He was home alone at the time.	当时佢独自系屋企。 
I'm tired of listening to his boasts.	我听厌佢牙擦擦。 
Because of heavy snow, the plane from Beijing arrived 20 minutes late.	由于大雪，从北京黎的飞机晏左四个字。 
You may use my new car.	你可以用我新车。 
Where is the vodka?	伏特加系边呀？ 
If a person has not had a chance to acquire his target language by the time he's an adult, he's unlikely to be able to reach native speaker level in that language.	如果一个人成年后都冇机会揸手佢标的语言，佢就唔好可能去到母语水平。 
He hurried so he wouldn't miss the train.	佢匆忙，以免赶不上火车。 
Don't go out after dark.	天黑以后唔好出去。 
They arrived here safely yesterday.	佢地寻日安全到达尼度。 
None of those books are useful.	果的书冇一本系有用的。 
I just said something very stupid.	我刚刚讲左的好寿的野。 
If I were you, I'd want to know what Tom is doing right now.	如果我系你，我会想知阿Tom而家系度做紧咩。 
I often went fishing with him.	我成日同埋佢去钓鱼。 
I hope we find Tom.	我希望我地可以揾到阿Tom。 
You used to be able to see the church from here.	你以前可以系尼度体到教堂。 
Can we do it?	我地可以做到呀？ 
I've never told anyone about this.	我冇讲过任何人尼件事。 
One thousand dollars will cover all the expenses for the party.	一千美元可以支付今次聚会的所有使费。 
Fire is always dangerous.	火成日危险。 
The meeting was called off.	会议比取消左。 
They welcomed me warmly, so I felt at home.	佢地热烈甘欢迎我，所以我有宾至如归的感觉。 
Tom pulled Mary out of the water.	阿Tom将阿Mary水里拉左出黎。 
I have class tomorrow.	我听日有课。 
Tom fell asleep in class.	阿Tom上堂时训着左。 
Tom can't get his car started.	阿Tom发动唔到佢汽车。 
This is a very beautiful flower.	尼一朵好靓花。 
Best wishes from all of us.	我地所有人致以最大好的祝愿。 
My aunt gave me a camera.	我阿姨比左我一部相机。 
I don't understand music.	我唔识音乐。 
I wish I was young again.	我希望我又后生啦。 
I'm not guilty of anything.	我冇任何罪过。 
A bird can fly.	鸟会飞。 
His office is near the train station.	佢办公室系火车站附近。 
A swarm of hornets attacked the children.	尼班黄蜂袭击尼左仔们。 
She stirred her coffee with a teaspoon.	佢用茶匙搅拌咖啡。 
When are you going to quit smoking?	你打算几时戒？ 
He ran into the room.	佢跑进房。 
What are we having for dinner?	我地消夜食咩？ 
You'll get lost.	你会荡失路。 
My cell phone has a built-in digital camera.	我手机内建数码相机。 
Hold your horses, young man.	唔好心急，后生仔。 
Six divided by two equals three.	六除以二系三。 
I am able to drive a car.	我识揸车。 
I could answer all the questions.	我可以答所有的问题。 
Can you do bookkeeping?	你会记账吗？ 
They're all the same size.	佢地都一样大。 
What do you two do for fun?	你地两个做咩好玩的？ 
No one lives in this building.	这栋楼入便冇人住。 
I'm sick and tired of hamburgers.	我厌倦左汉堡包。 
They married when they were young.	佢后生果阵就结左婚。 
I would have liked to come with you, but I didn't have time.	我本来想同你一齐去的，但系我无时间。 
Academic fraud is more common than you might think.	学术欺诈比你想象的更加遍。 
That's exactly what I wanted to see happen.	尼个正系我想体到的。 
I'm afraid there isn't any coffee left.	体怕冇咖啡。 
While I was reading in bed last night, I fell asleep with the light on.	我寻晚摊系张床上体书的时候，开住灯训着左。 
He'll be back home soon.	佢好快就会返屋企。 
We sometimes swim in the lake.	我地有时系湖里游水。 
Charles Lindbergh made the first solo flight across the Atlantic Ocean in 1927.	查尔斯·林德伯格于1927年首次独自飞越大西洋。 
His shirt was stained with sauce.	佢衬衫比酱汁整污糟啦。 
I am just going for a walk.	我只系去散散步。 
We found the front door locked.	我地发现前门比锁。 
He is so heartless.	佢好倔情啦。 
I'm playing a TV game.	我玩紧电视游戏。 
Let's go now.	我地而家走啦。 
Control is everything.	控制就系一切。 
Swimming is easy.	游水好易。 
He held a package under his arm.	佢胳肋底挟住个包裹。 
She looks pretty in that dress.	佢着果件衫好靓。 
Why are you here?	你做咩系度？ 
She asked us to leave her alone.	佢比我地行佢远的。 
Thanks very much for having me to dinner the other night.	多谢晒果晚请我食饭。 
After they argued, they didn't speak to each other for a week.	佢地拗撬之后，一个礼拜冇讲。 
Tom slipped out of the classroom.	阿Tom松出左班房度。 
You ought to ask for your teacher's permission.	你应该征得老师的同意。 
The clock has stopped.	钟停左。 
When did your friend leave for America?	你的朋友几时去美国的？ 
They grow flowers in the garden.	佢地系花园度种花。 
She told me an interesting story.	佢比我讲左个得意的故事。 
I received her letter yesterday.	我寻日收到左佢信。 
I slept on the bus.	我系巴士度训觉。 
Stand aside.	企埋便呀。 
By the year 2020, the population of our city will have doubled.	到2020年，我地城市的人口将抄一番。 
Tom has been really busy recently.	阿Tom尼排真系好忙。 
The swimmers were numb with cold.	游泳者冻到痹啦。 
Many moons orbit around Saturn.	好多卫星围绕土星运行。 
I spent the whole day in reading the novel.	我用左成日体小说。 
Volcanic ash disrupted air travel.	火山灰扰乱左航空旅行。 
I'm surprised that you don't know about their marriage.	我好惊讶你竟然唔知佢地的婚礼。 
Mom, I'm hungry.	妈咪，我好肚饿。 
He earned his living as a teacher.	佢以做老师为生。 
She loves chocolate, too.	佢都钟意朱古力。 
It has been cold since yesterday.	由琴日开始就一直好冻。 
She must have been sick.	佢一定系病。 
I'm not very good at swimming.	我唔系好擅长游水。 
Switch on the light. I can't see anything.	打开灯。 我咩都体唔到。 
Do you drink coffee?	你饮咖啡啊？ 
I promise I'll do that tomorrow.	我保证我听日会做果件事。 
Some people never grow up.	有的人永远长唔多。 
I will write to you soon.	我好快会写信比你。 
I'm starving!	我饿死啦！ 
This place has a mysterious atmosphere.	尼个地方有一种神秘的气氛。 
It takes 165 years for Neptune to orbit around the sun.	海王星兜太阳一周需要165年。 
The curtain fell.	幕布留低左。 
I expect you to be punctual.	我希望你准时。 
While reading a book, I fell asleep.	系体书的时候，我训着左。 
You shouldn't have eaten so much ice cream.	你唔应该食甘多雪糕。 
You have a point there.	你讲得有道理。 
Quit gambling.	戒掉赌。 
Cows provide us with milk.	奶牛为我地讲吓野啦！牛奶。 
She enjoyed herself at the concert.	佢系音乐会度玩得好开心。 
She gave me a strange look.	佢怪甘体左我一眼。 
I am an optimist by nature.	我天生系个乐观主义者。 
He erased his speech from the tape.	佢将佢讲野由录音带上吖。 
Do you have a larger size?	你有大一号的咩？ 
Do they love each other?	佢地大家相爱吗？ 
Halley's Comet will come back in 2061.	哈雷彗星将于2061年回归。 
I'm not living with him anymore.	我唔再同佢系埋一齐。 
My aunt brought me some flowers.	我阿姨比我带黎左一的花。 
I don't have a computer at home.	我屋企，无电脑。 
I returned the book to the library.	我还返本书比图书馆啦。 
Who can tell the difference?	边个可以体出有咩唔同？ 
I'll eat here.	我系度食。 
Tom needed treatment.	阿Tom需要治疗。 
She must still be in her twenties.	佢肯定仲廿几年。 
I wish Tom were my younger brother.	我希望阿Tom系我细佬。 
Do you eat out often?	你成日系出便食饭呀？ 
I can do it alone.	我一个人可以做。 
He is very stingy with his money.	佢好洗钱孤寒。 
Give me a bottle of wine.	比我一支酒。 
I really want to speak English fluently.	我真系好想讲一啖流利的英语。 
The Oscar ceremonies are Hollywood's biggest extravaganza.	奥斯卡颁奖典礼系荷李活最大的盛会。 
Do you read French every day?	你每日读法文吗？ 
How much is the rent per month?	每个月租金几多？ 
The clock stopped.	自停左。 
Who is to blame for the accident?	边个要为今次事故负责？ 
I will give you a bike for your birthday.	我会送你架单车作为你的生日礼物。 
Deal with them.	对付佢地。 
She squeezed the juice from many oranges.	佢系好多橙中榨出果汁。 
I've never seen that guy before.	我都未见过果条友。 
It's obvious why his stomach hurts.	佢个肚好痛罗好明显。 
I wish I had a better memory.	我希望我有更好的记忆力。 
I don't feel like studying English today.	我今日唔想学英文。 
Sorry to have kept you waiting.	唔好意思，要你等甘耐。 
I don't think that she will come.	我认为佢唔会黎。 
No student went to the party.	冇学生去参加聚会。 
The roof was damaged by the storm.	瓦背顶比暴风雨损坏啦。 
Today our artificial satellites are revolving around the earth.	今日，我地的人造卫星屈住地球转。 
He teaches English to his friends.	佢教佢朋友英文。 
Have you turned in your report?	你交报告？ 
He wants a book to read.	佢想要一本书黎读。 
Sorry it took me so long to write to you.	唔好意思，过左甘耐先写信比你。 
They forgot to lock the door.	佢地唔记得锁门。 
Have you answered that letter yet?	你回复果封信呀？ 
Tom told me he had a right to see it.	阿Tom话比我知佢有权体。 
She really does like animals.	佢真系好钟意动物。 
What's the climate there like?	果度的气候点啊？ 
I like children. That's why I became a teacher.	我钟意细路仔。 尼个系我做老师罗。 
Here are some pictures.	尼度有一的图片。 
May I have a glass of milk, please?	唔该比杯牛奶好吗？ 
I'll be at home in the morning.	我朝早会系屋企。 
Will you show me your passport, please?	请出示你的护照好吗？ 
My father died of lung cancer.	我阿爸死于一个肺癌。 
How did you enjoy the concert?	你中意尼场音乐会吗？ 
This is exactly what I wanted.	尼个正系我想要的。 
That's my problem.	甘我的问题。 
Please let me go.	唔该比我走啦。 
I've missed another chance.	我又嘥左一次机会。 
I have a cough and a little fever.	我有无咳，仲有D发烧。 
I managed to get there in time.	我设法及时赶左去晒边。 
The lock is broken.	锁坏左。 
Half of these apples are rotten.	尼的苹果有一半烂了。 
I changed trains at Tokyo Station.	我系东京企换车。 
She's in the garden planting roses.	佢系个花园度种玫瑰花。 
Tom can't tell Mary his real feelings.	阿Tom唔可以话阿Mary佢真实感受。 
The guests are in the kitchen.	客，的人系厨房度。 
Would you like some of those pictures?	你想要一的的相呀？ 
I appreciate your cooperation.	我多谢你合作。 
I like swimming, but I don't like to swim here.	我钟意游水，但我唔钟意系尼度游水。 
I don't mind if it's a little cold.	我唔介意天时有的冻。 
The weatherman says there is a storm on the way.	天气预报员话暴风雨即将来临。 
How about a drink after the game?	比赛结束后饮杯点啊？ 
After you have read it, give the book back to me.	你读完之后，还返本书比我。 
I have a new car.	我有一部新车。 
I graduated from high school last year.	我旧年高中毕业啦。 
Keep going straight.	一直向前走。 
Smoking is prohibited.	禁止吸烟。 
Get them before they get us.	系佢地捉到我地之前捉到佢。 
Tom went into the kitchen and poured himself a cup of coffee.	阿Tom走进厨房，比自己倒左一杯咖啡。 
I think that's awful.	我觉得甘好可怕。 
Orange juice, please.	唔该比我橙汁。 
I continued singing.	我继续唱歌。 
They rescued the boy from drowning.	佢地溺水的男仔救左出黎。 
Tom is on the go day and night.	阿Tom日日频扑。 
You must be careful of the traffic when you cross the street.	你过马路果阵，一定要小心车流。 
He plays golf two or three times a month.	佢一个月打两三次哥尔夫球。 
Tom slept until noon.	阿Tom一直训到晏昼。 
He doesn't know how to swim.	佢唔识游水。 
He'll do whatever you ask him to.	你比佢做的咩佢就做咩。 
Whether you like it or not doesn't matter.	你钟唔钟意唔紧要。 
You have no right to interfere in other people's affairs.	你冇权利干涉人地的事。 
I'll alert Tom.	我会通知阿Tom。 
No problem.	无问题。 
You may take either the big box or the small one.	你可唔可以罗大盒，都可以罗细个盒。 
Do you know where Tom is waiting for us?	你知道汤姆系边度等我地呀？ 
I'm doing my homework.	我系度做工作。 
Nature is full of mysteries.	大自然充满左神秘。 
You're barking up the wrong tree.	你找错对象。 
I'm not letting Tom do this by himself.	我唔会比阿Tom一个人做尼件事的。 
She would often go to the theater when she was in London.	佢系伦敦果阵成日去剧院。 
We'll need a head hunting agency to find the right man for this executive position.	我地要一家猎人头公司黎为尼个行政职位揾到啱的人选。 
Can anyone believe you?	有人可以信你呀？ 
He is making great progress in English.	佢的英文进步好大。 
My father has been engaged in foreign trade for many years.	我阿爸从事外贸已经好多年啦。 
She has lost weight.	佢体重减轻啦。 
I'm tired of your complaints.	我厌倦左你怨。 
I don't want to have an operation.	我唔想做手术。 
I like this color as well.	我都钟意尼个颜色。 
I need to try.	我需要试。 
He left his umbrella on the bus.	佢把遮落系巴士度。 
My aunt made me a new skirt.	我阿姨比我做左一条新裙。 
She used to go to the movies on Sundays.	佢以前成日星期日去体电影。 
Everyone knew Tom was the one who did it.	个个都知道阿Tom做的。 
You might not like this beer at first. It's an acquired taste.	一开始，你可能唔钟意的啤酒。 尼一种后日整成的习惯。 
I am interested in music.	我对音乐有兴趣。 
I don't get what you mean.	我唔明你的意思。 
Where in Turkey do you live?	你系土耳其咩地方？ 
She showed us a beautiful hat.	佢比我地体左顶好靓的帽。 
He didn't come to the last meeting.	上次会议佢冇黎。 
It can be dangerous.	尼可能好危险。 
I have no intention of asking him.	我无意问佢。 
I agreed to the proposal.	我同意左尼个好提议.. 
It is like looking for a needle in a haystack.	尼，就好似大海捞针。 
Summer has ended.	夏天已经结束嘞。 
It's a very sad story.	尼个系一个好悲伤的故事。 
We're out of stock now.	我地而家冇货。 
Turn off the television. I can't concentrate.	将电视关掉。 我唔集中注意力。 
We need some more coffee.	我地要多的的咖啡。 
Most boys like baseball.	大多数男仔钟意棒球。 
You should have told me a long time ago.	你早货抵话比我知啦。 
Swimming is good for your health.	游水对你的健康有着数。 
This is Uncle Tom's farm.	尼个系阿Tom阿叔的农场。 
Pass me the salt, please. "Here you are."	唔该将盐比我。 “比你。” 
You are a student.	你系个学生。 
May I ask how old you are?	请问你几大啊？ 
I've finished watering the flowers.	我已经淋完花左。 
Tom wanted Mary to say that she loved him.	阿Tom想比阿Mary话佢爱佢。 
Please answer this question for me.	唔该帮我答尼个问题。 
Does she know your telephone number?	佢知道你个电话号码啊？ 
The picture looks better at a distance.	尼幅画远体更加好体。 
I invited them to the party.	我请佢地参加聚会。 
He returned from China.	佢系中国返黎嘞。 
The accident seemed to have something to do with the heavy snow.	今次事故似乎与大雪有关。 
Do we have anything I can snack on?	我地有咩，我可以食口立湿吗？ 
I think his opinion is very important.	我认为佢意见好重要。 
I am looking forward to Christmas.	我等左好耐住圣诞节。 
Do you like to cook Japanese foods?	你钟意做日本打理吗？ 
Why should it be different?	点解唔系一样？ 
Computers are certainly playing an important role in our life, whether we like it or not.	唔理我地中唔中意，电脑系我地的生活中演住重要的角色。 
Tom was all worn out.	阿Tom筋疲力尽啦。 
All the boys in class worked hard.	班上所有的男生都好努力。 
Studying abroad is very common now.	而家系外国读书好遍。 
Tom burst into tears.	阿Tom突然间大哭起身。 
Why do I have to do that?	我点解要甘做呀？ 
That bicycle is too small for you.	果架单车对你黎讲细得济啦。 
Do you know how to recover a deleted file?	你知点恢复比删除的文件吗？ 
Keep the dog out.	只狗遮系出便。 
I don't like novels without heroes.	我唔中意有冇英雄的小说。 
Is there a zoo in the park?	公园有动物园吗？ 
Tom suggested that I change the lock on my door.	阿Tom建议我换下门锁。 
I am very, very sorry.	我好好对唔住。 
The best hairdressers are gay.	最好的发型师都系基佬。 
I love elderberry juice.	我钟意接骨木果汁。 
She studied English in the morning.	佢朝头早学英文。 
The death penalty had been done away with in many states in the USA.	美国好多非洲已经废除左死刑。 
I understand perfectly.	我完全理解。 
What do you think of him?	你觉得佢点啊？ 
Tom is an extraordinary man.	阿Tom系一个非凡的人。 
The phone is ringing.	电话响左。 
Could you check the tire pressure?	你可唔可以检查一下车軚气压吗？ 
The charge for a front row seats is 5 dollars.	前排座位的费用系5美元。 
Obey your teachers.	敢唔听你个老师。 
No words can express her deep sorrow.	冇语言可以表达佢深深的悲痛。 
His house was small and old.	佢间屋又小又旧。 
You must get up a little earlier.	你一定要早的起身。 
Please show your ticket.	请出示你的飞。 
He took a week off.	佢请左一周假。 
Could you please not smoke in this room?	请你唔好系尼个房食烟好吗？ 
I'm sorry for the late response.	对唔住，甘迟先回复。 
My brother and I are in the same class.	我阿哥同我系同一个班。 
There are about forty students in her class.	佢班上约莫有四十个学生。 
I really want to know what's going on.	我真系好想知道尼系乜事。 
The shell of an egg is easily broken.	鸡蛋的壳好易烂。 
You've got a lot of guts.	你好够胆。 
It's said that she loves him.	听讲佢爱佢。 
I didn't like it.	我唔中意佢。 
What do you have the first period?	你有咩第一次月经？ 
He is now either in Rome or in Paris.	佢而家唔系罗马就系系巴黎。 
He is a doctor by profession.	佢的职业系医生。 
I'd like to be a guitarist.	我想成为一个结他手。 
Starting tomorrow, it's going to snow for a week.	系听日开始，将会下个礼拜的雪。 
My bicycle has a flat tire.	我架单车爆胎啦。 
Of course she can speak English.	佢当然会讲英文。 
Take things a little more seriously.	将野体得更重一D。 
Could I have a pillow and blanket?	可唔可以比我个枕头同氊吗？ 
Get out of here.	离开尼度。 
Stir the soup.	搅拌汤。 
We're almost broke.	我地几乎执笠啦。 
How many apples do you want?	你要几多苹果？ 
There's a telephone in my room.	我间房里面有一部电话。 
What prevented you from coming earlier?	系咩阻止都左你早的黎？ 
I don't need your help.	我唔需要你的帮助。 
I'm at the airport now.	我而家系机场。 
Haven't we met before?	我地以前未见过面吗？ 
That's my final answer.	尼个系我最后的答。 
I'm tired of her complaints.	我厌倦左佢怨。 
You must keep quiet for a few days.	你一定要安静几日。 
He asked her where her mother was.	佢问佢阿妈系边。 
This law is applicable to all cases.	尼项法律适用于所有情况。 
I want to go with you.	我想同你一齐去。 
It's healthy to breathe deeply.	透大气系有益健康的。 
When she saw that they had no schools, she started one.	当佢见到佢地冇学校的时候，佢开办左一间。 
I'm sure you'll love what we have on the menu tonight.	我相信你会钟意我地今晚菜牌上面的菜。 
Have you taken your medicine yet?	你食药呀？ 
The couple is walking hand in hand.	尼对夫妇手牵着手走住。 
There was a car accident yesterday.	寻日发生左撞车。 
Life is like a box of chocolates.	生活好似一盒朱古力。 
If she was displeased, she never showed it.	如果佢唔开心，佢从不表现出黎。 
I saw him running.	我见到佢系走。 
Stick a stamp on the envelope.	系信封度贴一张邮票。 
Do you want to know why I quit?	你想知我点解辞左职啊？ 
Who was in charge of today's party?	今日的晚会系边个主持的？ 
Is there an app for that?	有尼方面的应用吗？ 
If a sick person folds one thousand paper cranes, her wish will come true.	如果个病人折一千只纸鹤，佢愿望就会实现。 
Never forget to put out the fire.	千祈唔好唔记得灭火。 
Do you plan to stay long?	你打算屈好耐呀？ 
I haven't seen Tom since 1988.	自从一九八八年以黎，我就冇见过阿Tom。 
We made it out of there.	我地几难逃出去啦。 
My father works at the factory.	我阿爸打工厂工。 
I usually go to bed before ten.	我通常系十点前训教。 
What is my room number?	我间房号系几多啊？ 
The man got away from the city.	果个人逃离左城市。 
I don't blame you for doing that.	我唔怪你甘做。 
I missed you.	我想你啦。 
I'll give you anything that you want.	你想要咩，我就比你呀。 
I know the girl playing tennis.	我识果个打网球的女仔。 
Thank you for inviting me to dinner.	多谢你请我食饭。 
She greeted us with a smile.	佢笑笑口甘同我地打招呼。 
Entering the house, I tripped over the mat.	一进屋，我就比荐纩亲啦。 
If we knew what we were doing, it wouldn't be called research, would it?	如果我地知道自己系度做紧咩，就唔会叫研究左呀？ 
The bookcase is level with the table.	书柜与枱平齐。 
There's too much salt in this soup.	尼个汤里盐太多啦。 
You're an optimist.	你系一个乐观主义者。 
The box is too heavy to carry.	尼个箱太重，搬唔郁。 
Tom was there this morning.	阿Tom今朝系果度。 
I don't understand what he said.	我听唔明佢讲的说话。 
I treated her as my own daughter.	我将佢是自己的女。 
We haven't finished eating the watermelon yet.	我地都未食完西瓜尼。 
He did not know what to say.	佢唔知讲乜。 
Have you heard from him?	你有佢的消息啊？ 
I'll give you a little tip.	我比一的小贴士。 
The oranges in this bag are rotten.	尼个袋入面的橘子烂晒。 
There is no point in pretending to be sick.	诈病系冇意义架.. 
He wrote a book about a jungle adventure.	佢写左一本关于丛林探险的书。 
Both you and I are men.	你同我都系男人。 
The boy made fun of the girl.	男仔笑女仔。 
Second semester has ended.	第二学期已经结束嘞。 
Maybe you could draw me a picture.	或者你可唔可以比我画一幅画。 
She cut the apple with a knife.	佢用刀切苹果。 
This house belongs to my uncle.	尼间屋系我阿叔的。 
That car belongs in a museum.	果架车系属于博物馆。 
You can borrow my car anytime.	你随时都可唔可以借我架车。 
He is one of my neighbors.	佢系我个隔离。 
I carried the box on my shoulder.	我将箱托系膊上。 
Is this snake safe to touch?	玷尼条蛇安全啊？ 
They told me it was your fault.	佢地话比我知你错。 
Everybody knows that he is honest.	个个都知佢系诚实的。 
I just don't want to lose you.	我只系唔想失去你。 
I told them to send me another ticket.	我话佢地再比我寄一张票。 
I saw it in the newspaper.	我系报纸上体到的。 
Tom finally understood it.	阿Tom终于明白啦。 
The teacher pointed her finger at me and asked me to come with her.	老师用手指住我，等我同佢一齐去。 
Have you ever broken your glasses?	你曾经打碎吖过你副眼镜吗？ 
Don't shout at me.	唔好对我大喊大叫。 
News of the recent blast is all over the radio.	收音机度周围都系最近爆炸的消息。 
Don't you miss anything?	你冇错过咩呀？ 
They were not listening to music.	佢地冇系听音乐。 
I do not drink coffee.	我唔饮咖啡。 
Everybody wants to sit beside her.	个个都想坐系佢隔离。 
You may think those shoes are in fashion, but they aren't.	你可能认为的鞋好兴，但事实并非甘。 
He picked flowers for her.	佢同佢摘花。 
I can do it in a week.	我可唔可以系一个星期内完成。 
You're not satisfied, are you?	你唔满意，系未啊？ 
She weeded the garden.	佢系个花园度除草。 
Afraid of hurting his feelings, I didn't tell him the truth.	我惊伤害滴感情，所以冇话比佢个真相。 
Tom is a hick.	阿Tom系个乡下佬。 
I don't want to miss my train.	我唔想嘥我的。 
I want to go to Seattle.	我想去西雅图。 
Tom has forgotten how to do that.	阿Tom唔记得左点做果件事。 
The army forced him to resign.	军队迫使佢辞职。 
How about going to see a movie tonight?	今晚去体电影点啊？ 
I need it ASAP.	我要佢尽快。 
I'm in a bad mood today.	我今日心情唔好。 
In the winter, many older people slip on ice and fall down.	冬天，好多老人家系雪上跣亲。 
Something might have happened to her.	佢可能出左乜野事。 
Can I see that one?	我可唔可以体下果个呀？ 
There's enough time for a quick snack.	有紧要的时间吃快餐。 
I stayed at home last night.	我寻晚留系屋企。 
I don't have the address now.	我而家冇地址。 
Do you know me?	你识我呀？ 
I remember the first time.	我记得第一次。 
I don't think he'll say yes.	我想佢唔会答应。 
Tom doesn't really love Mary.	阿Tom唔系真系爱阿Mary。 
Money talks.	金钱大晒。 
He hid himself behind the door.	佢匿系门后。 
We imported meat from Argentina.	我地系亚根廷进口肉。 
Christmas is soon.	圣诞节就到了。 
I'm in love with her.	我钟意佢。 
I ran away in a hurry.	我急急脚甘走左。 
With the weather getting worse, the departure was put off.	由于天气变坏，启程比延后啦。 
Tom's house has a nice garden.	阿Tom的屋有一个好靓的花园。 
I was invited to their wedding.	我比邀请参加佢地的婚礼。 
I lost.	我输左。 
I quit smoking two years ago.	我两年前戒左。 
Apart from some fruit, he hasn't eaten anything.	除左一的生果，佢咩都冇食。 
Why do you need this money?	你点解要尼笔数？ 
These fireworks are spectacular!	尼的烟花太壮观啦！ 
He wants more.	佢想要多的。 
Passengers should board the train now.	乘客而家应该上车啊。 
When was this university founded?	尼间大学系几时建立的？ 
She dived into the swimming pool.	佢跳入游水池。 
You should bring your passport to the bank.	你应该带住护照去银行。 
I like oranges better than apples.	比起苹果，我钟意橘子。 
I got a farewell present from everyone.	个个都比我一份告别礼物。 
Which tooth hurts?	边粒牙疼？ 
Tom didn't have enough money to pay the rent.	阿Tom冇紧要的钱比屋租。 
I'm thirsty.	我口渴到嘞。 
I don't have a prejudice against foreign workers.	我对外国工人冇偏见。 
I see her sweeping the room.	我见到佢系打扫房间。 
Are you angry?	你嬲左呀？ 
Please pass me the butter.	唔该将牛油比我。 
I can't do any more than this.	我唔再做尼个啦。 
Let's take the children to the zoo.	我地带仔们去动物园啦。 
I majored in chemistry at the university.	我系大学主修化学。 
He broke the window on purpose.	佢特登打烂窗。 
I always study hard.	我成日努力学习。 
The talks will last three days.	会谈将持续三日。 
Please don't tell your parents this.	请唔好话你父母尼件事。 
Dog is man's best friend.	狗系人类最好的朋友。 
We'll begin work soon.	我地好快就要开始做野。 
In a way you are right, but I still have doubts.	系某种程度上你系啱的，但我仍有疑虑。 
I wrote this book.	我写左尼本书。 
He told the students to be quiet.	佢叫学生们安静。 
Didn't you lock up your car?	你冇锁好车吗？ 
What is the name of this river?	尼条河叫咩名呀？ 
She had died before I arrived.	系我到达之前，佢已经过左身。 
Take good care of yourself.	比心机照顾自己。 
My underpants are wet.	我条底裤湿晒。 
I don't need you or anybody else.	我唔需要你或者任何人。 
He knows who they are.	佢知佢系边个。 
Tom can't afford this.	汤姆买唔起尼个。 
Tom didn't want to disappoint Mary.	阿Tom唔想比阿Mary失望。 
It was very kind of you to lend me an umbrella.	你把遮比我真系好。 
He put on the red jacket.	佢着上红色飞机恤。 
He offered his help to us.	佢投怀向我地讲吓野啦！帮助。 
The moon is the earth's only satellite.	月光系地球上唯卫星。 
April showers bring May flowers.	四月的过云雨带黎五月的花朵。 
I went to sleep about 10 o'clock.	我大约十分钟就训着左。 
I went to a park this morning.	今日朝早我去左个公园。 
What's your name?	你个名？ 
Are you afraid of Tom?	你惊阿Tom吗？ 
We have less than five minutes to evacuate the whole building.	我地得唔到五分钟时间疏散成栋大楼。 
She has a real knack for getting people to do what she wants.	佢有比的人做佢想做的事的诀窍。 
Talking during a concert is rude.	系音乐会上讲野系冇礼貌的。 
You can hold my hand.	你可唔可以揸住我手。 
He will arrive in Paris tomorrow.	佢听日就到巴黎。 
This conference is very important. Don't miss it.	今次会议非常重要。 唔好错过。 
Her success made her the target of jealousy.	佢成功令佢成为妒忌的对象。 
He plays the guitar very well.	佢结他弹得好好。 
I am disgusted with him.	我憎佢。 
It is a pity that you cannot come to the party.	好可惜你唔离参加聚会。 
You should quit smoking.	你应该戒。 
What is learned in the cradle is carried to the tomb.	系摇篮度学到的野会比带到坟墓度。 
He's eating an apple.	佢系食苹果。 
She is always losing her handkerchief.	佢成日都唔见手巾仔。 
Please return the book by tomorrow.	唔该系听日之前归还尼本书。 
I'm proud of you.	我帮你觉得牙擦。 
She spends her leisure time making dolls.	佢利用闲暇时间制作公仔。 
Many kinds of birds live in Japan.	好多种类的雀生活系日本。 
I wrote a letter to my mother.	我比妈妈写左一封信。 
You and I have the same idea.	你同我的想法系一样的。 
She should have been more careful.	佢应该更加小心的。 
I hope everything goes well.	我希望一切顺利。 
I wish I could talk to you.	我希望可以同你倾。 
I would rather not go there alone.	我宁愿唔一个人去果度。 
You talk too much.	你话太多啦。 
You must keep your eyes open.	你一定要瞠大只眼。 
Nobody tried to help Tom.	有冇人试图帮助阿Tom。 
You two should get married.	你地两个应该结婚啦。 
Tom is probably pretty rich by now.	阿Tom而家可能相当有钱嘞。 
How many does he want?	佢要几多？ 
Thank you for drawing a bird for me.	多谢你为我画左一只雀仔。 
I'm looking for a part-time job.	我系揾份兼职工作。 
I can read German, but I can't speak it.	我可唔可以看懂德文，但我唔会话德文。 
Something must be wrong with the machinery.	一定系机出左问题。 
I want beef, too.	我都要牛肉。 
I'd rather stay than go.	我宁愿留低都不愿走。 
I had a tennis match with him.	我同佢打左一场打网球。 
He's a comedian.	佢系一个喜剧演员。 
India is a developing country.	印度系一个开发中国家。 
He is old enough to drive.	佢已经到揸车的年纪啦。 
I arrived in London.	我到伦敦。 
I saw five men.	我体到五个人。 
I got up early in the morning.	我朝早起得好早。 
I hate chemistry.	我憎化学。 
May I ask you some more questions?	我可唔可以再问你几个问题呀？ 
I don't understand.	我唔明。 
May I say something?	我可以讲的咩呀？ 
What is this?	尼的系咩？ 
I am going to Hawaii next year.	我出年要去夏威夷。 
Don't throw rocks into the river.	唔好去河里掟石。 
I've had enough of your lying.	我受够左你大话。 
We had an early lunch at school.	我地系学校早早甘食左晏。 
The road is too narrow for cars.	尼条路好窄，汽车走唔郁。 
I do not agree with you at all.	我完全唔同意你的观点。 
Are you saying you don't want to go to Tom's party?	你话你唔想去阿Tom的派对吗？ 
Tom knew when Mary would be arriving.	阿Tom唔知阿Mary几时到。 
Pride goes before a fall.	沙尘使败。 
Why did you turn down his offer?	你点解拒绝佢好提议。？ 
Japan is a rich country.	日本系一个富裕的国家。 
I can't stand that noise.	我顶唔顺果的噪音。 
You'd better go.	你最好行啦。 
Turn off the TV.	将电视关掉。 
I don't want to work.	我唔想做野。 
I hope to see you.	我希望可以见到你。 
Tom got a late start this morning.	阿Tom今日朝早起身晏了。 
He is not from Hokkaido.	佢唔系北海道人。 
What subjects are you taking at school?	你系学校学咩D科目啊？ 
Get Tom.	揾阿Tom。 
What is the total amount of money you spent?	你总共花左几多钱？ 
He likes taking care of the garden.	佢钟意打理花园。 
Her red dress made her stand out.	佢红色衫裙令佢显得好出位。 
At last, she solved the problem.	最后，佢解决左尼个问题。 
He made many excuses for being late.	佢为迟到揾左好多借口。 
Will you all be here tomorrow?	你听日都系吗？ 
She gives me a nasty look every time she sees me.	佢次次见到我都恶死能登甘体我一眼。 
Close the door when you leave.	你走的时候，关上门。 
They passed by her house yesterday.	佢地寻日路过佢。 
Excuse me, I'm lost.	对唔住，我荡失左路。 
This is what I can do for you.	尼个系我可唔可以帮你做的。 
We gladly accept your offer.	我地欣然接受你地的报价。 
I want to drink something cold.	我想饮的冻的。 
You look tired.	你好似好攰。 
I'll go shopping tomorrow.	我听日去行街。 
I would like to know her name.	我想知佢个名。 
My father has five siblings.	我阿爸有五个兄弟姊妹。 
She glanced briefly at the newspaper.	佢匆匆体左一眼报纸。 
The parking lot is free of charge.	停车场系免费的。 
I will pick you up around six.	我六点左右去接你。 
We don't have any other choice.	我地冇得拣。 
The sun rose over the horizon.	太阳由地平线升起。 
Do you feel tired?	你觉得攰啊？ 
A green carpet will not go with this blue curtain.	绿色地氊与蓝色窗帘唔衬。 
Maybe you'll succeed.	或者你会成功。 
I feel very sorry for your sister.	我帮你妹觉得好难过。 
That red dress suited her.	果件红色衫裙好啱佢。 
You need a car if you live in the suburbs.	如果你住系郊区，你要一部巴士。 
How come you didn't say anything?	你点咩都冇话？ 
I meet him at the club.	我系俱乐部见过佢。 
Today was fun.	今日好得意。 
I don't know how to go there.	我唔知点去果度。 
Give us two knives and four forks, please.	唔该比我地两把刀同四支叉。 
She made him a new suit.	佢比佢做左一套新衫。 
I want to see your older sister.	我想你家姐。 
Her argument was not based on facts.	佢论点冇事实根据。 
The cost of living has risen.	生活使费上涨啦。 
Don't show your face around here again.	你唔好再系尼度蒲头嘞。 
I want you to stay here until I get back.	我要你留系尼度直我返黎。 
Do you know what I mean?	你知唔知我意思啊？ 
The accident's only survivor was a baby.	事故中唯幸存者系个苏虾仔。 
It's just what I wanted.	尼个正系我想要的。 
How about playing chess tonight?	今晚捉棋点啊？ 
Actions speak louder than words.	行动胜于雄辩。 
Tom is waiting for everyone to leave.	阿Tom系度等大家离开。 
I don't mind hot weather.	我唔介意暑热的天气。 
He is always losing his umbrella.	佢成日都唔见遮。 
My birthday falls on Sunday.	我的生日系星期日。 
He plays baseball every day.	佢日日都打棒球。 
Hokkaido is very far, isn't it?	北海道很远，唔系咩？ 
She's neither rich nor famous.	佢既唔有钱都唔出名。 
I went skiing at Zao last winter.	旧年冬天我去枣滑雪啦。 
Please show me the menu.	唔该比我体下菜单。 
Give it to them.	比佢地。 
I can't stand this heat.	我顶唔顺甘热。 
Does this bus go to the beach?	尼架巴士去海滩啊？ 
Please show me around.	唔该带我周围体体。 
Take as many peaches as you like.	你想罗几多桃子就罗几多。 
I heard the song sung in French.	我听到尼首歌系用法文唱的。 
She's absent because she's sick.	佢缺席，因为佢病左。 
The problem was very difficult.	尼个问题好难。 
I live in this neighborhood.	我就住系尼度附近。 
You're a real friend.	你系一个真正的朋友。 
The robot went out of control.	机械人失控啦。 
If it happened to Tom, it could happen to you.	如果发生系阿Tom身上，都可能会发生系你身上。 
He goes to school on foot.	佢行去返学。 
I just talked to the person in charge.	我刚刚同负责人讲过。 
He's an excellent brain surgeon.	佢系一个优秀的脑外科医生。 
Under no circumstances must you leave the room.	系任何情况下，你都唔可以离开间房。 
Please call me up between seven and eight.	唔该系七点到八点之间打电话比我。 
They became friends in elementary school.	佢地系小学就成左朋友。 
They live across the river.	佢地系河对岸。 
He is alone.	佢独自一人。 
He is always at home on Mondays.	星期一佢成日系屋企。 
Give me some milk, too.	都比我的牛奶。 
He made friends with her in America.	佢系美国同佢交朋友。 
Are you planning to take part in the meeting?	你打算参加会议吗？ 
I'm sure that it'll be fun.	我肯定会好得意的。 
You should pay more attention to his warnings.	你应该注意佢叫。 
His mother looks young for her age.	佢阿妈好似过实际年龄后生。 
It happened at a quarter past eleven.	事情发生系十一点十五分。 
I know that it is highly unlikely that anyone knows me.	我知唔太可能有人识我。 
We kept quiet.	我地保持沉默。 
What's she doing?	佢系度做紧咩啊？ 
This is not a sentence.	唔系一句说话。 
Cover your head when you are in the sun.	当你系阳光下时，遮住你个头。 
She believes that he is innocent.	佢相信佢系无辜的。 
The taxi has arrived.	的士到啦。 
Why did you paint the bench red?	你点解将的凳油成红色？ 
I'd like a window seat, please.	我想要一个靠窗的座位。 
She always gets her own way.	佢成日为所欲为。 
He rushed out of the office.	佢冲出左办公室。 
Lansing is the state capital of Michigan.	兰辛系密执安非洲的首府。 
He has no interest in politics.	佢对政治唔有兴趣。 
What I'm about to say is strictly between you and me.	我要讲的系你我之间的秘密。 
He thanked me for coming.	佢多谢我到的。 
I threw a stone at the bird.	我同果只雀掉左一块石。 
I didn't get along with her.	我同佢相处得唔好。 
We didn't break in.	我地冇破门而入。 
How did you draw this picture?	你系点样画出尼幅画的？ 
That's too bad.	好唔好彩嘞。 
He lives somewhere about here.	佢住系尼度附近的某个地方。 
The deadline is approaching.	截止日期就到了。 
He was caught cheating in the exam.	佢考试茅招比人拉左。 
It is imperative for you to act at once.	你一定要即刻做野。 
I want to see him very much.	我好想佢。 
He likes to cook for his family.	佢钟意为屋企人煮饭。 
I'm currently a teacher at this school.	我而家系尼间学校的老师。 
I was surprised at his strong resemblance to his father.	我好惊讶佢同佢老豆生得甘似。 
Her mother always accompanies her.	佢阿妈成日陪住佢。 
We set a trap to catch a fox.	我地设左个陷阱黎拉狐狸。 
Do I have to stay in the hospital?	我一定要留系医院吗？ 
Eighty percent of all information on computers around the world is in English.	全世界电脑上80%的信息都系英文的。 
She really wants to go.	佢真系好想去。 
Can I speak to the head nurse?	我可唔可以同护士长讲呀？ 
He didn't show up at the party.	佢冇出现系聚会上。 
Please wrap it like a Christmas present.	唔该将佢好似圣诞礼物一样包装起上黎。 
Alcohol consumption is increasing every year.	酒精消费量年年都系增加。 
Monopoly is a popular game for families to play.	大有钱人系一个受家庭欢迎的游戏。 
Don't beat around the bush.	唔好拐弯抹角。 
I have eight brothers and sisters.	我有八个兄弟姊妹。 
Hurry, and you will catch the train.	快的，你会赶上火车的。 
No one voted against it.	冇人投反对票。 
She asked him questions.	佢问左佢一的问题。 
I am quite all right now.	我而家几好的。 
I can play Chopin.	我会弹萧邦。 
He was wounded in the war.	佢系战争中受左伤。 
I don't like the taste of onions.	我唔中意洋葱的味道。 
He cannot afford to buy a car, much less a house.	佢买唔起车，更加唔使讲屋啦。 
Don't hesitate to ask questions.	唔好犹豫问问题。 
Aren't you Tom?	你唔系阿Tom吗？ 
He's stronger than you.	佢比你强壮。 
Your assistance is indispensable for us.	你的帮助，对我黎讲系不可缺少的。 
Why am I still here?	点解我仲系度？ 
Watching TV is a passive activity.	体电视系一种被动的活动。 
What have you come here for?	你黎尼度做咩呀？ 
I want to ask you some questions about Tom.	我想问你的介绍阿Tom的问题。 
Would you pass the salt, please?	唔该将盐比我好吗？ 
There is a television in the room.	间房里面有部电视机。 
Could you please speak a little bit more slowly?	你可唔可以讲慢少少呀？ 
I forgot the date of the meeting.	我唔记得左开会的日期。 
What is love?	乜系爱情？ 
My legs still hurt.	我只脚仲痛。 
Between you and me, I don't like our new team captain.	系你我之间，我唔钟意我地的新队长。 
Are you really going to London to study?	你真系要去伦敦学习啊？ 
He has already had lunch.	佢已经食左晏了。 
I owe him 1,000 dollars.	我争佢1000美元。 
I don't have to clean my room.	我唔使打扫我间房。 
He is not an American.	佢唔系美国人。 
Turn off the gas.	关掉煤气。 
I have met him before.	我以前见过佢。 
It's not that easy to learn a new language after fifty.	五十岁以后学一门新语言唔系甘易。 
It's impossible to get there by noon.	中午之前到达果度系冇可能的。 
The teacher demonstrated the idea with an experiment.	老师用实验证明左尼个想法。 
Everyone noticed.	大家都留意。 
He plays tennis very well.	佢打网球得好好。 
That's good, isn't it?	甘好好，唔系咩？ 
Get me a ticket, please.	唔该比我买张飞。 
You only gave me fifty cents.	你只比我五十毫子。 
That's an interesting idea.	尼个系一个得意的想法。 
I clapped my hands.	我拍左拍手。 
You could've answered that question.	你本可以答尼个问题的。 
What's your marital status?	你个婚礼野点啊？ 
I do not remember seeing the letter, but perhaps I read it.	我唔记得见过果封信，但或者我读过。 
She might know that we are here.	佢可能知道我地系尼度。 
I was ashamed of my behavior.	我为自己的行为觉得羞愧。 
He hasn't answered my letter yet.	佢都冇比我回信。 
This writer is Russian.	尼位作系俄罗斯人。 
The cat got through the hedge.	猫穿过树篱。 
Will it take long to recover?	有需要好长时间啊？ 
I envied his new house.	我羡慕佢新屋。 
When does that start?	几时开始？ 
She doesn't have any enemies.	佢冇任何敌人。 
Winds from the sea are moist.	从海上黎的风系潮湿的。 
Do you have these shoes in my size?	尼对鞋有我晒士吗？
I wish you'd go.	我希望你可以去。 
I will stay until tomorrow.	我一路留到听日。 
I'll prove it to you.	我会证明比你体的。 
He kept his promise and helped his brothers.	佢信守诺言，帮助佢兄弟们。 
Where in Canada are you from?	你黎自加拿大边呀？ 
How about some more roast beef?	再黎的烧牛肉点啊？ 
Have you ever seen Tokyo Tower?	你见过东京铁塔吗？ 
My mother is a good woman.	我阿妈系个好女人。 
I was unable to go to his birthday party.	我冇可以去参加佢生日会。 
Are you planning to help them?	你打算帮助佢地呀？ 
What time will you have breakfast?	你几时食早餐啊？ 
Why me?	点解我？ 
This book is beautifully illustrated.	尼本书插图精美。 
The fox and the bear lived together.	狐狸同熊系埋一齐。 
Do you think I'm crazy?	你觉得我黐左线呀？ 
Read it once more, please.	唔该再读一次。 
It looks like a duck.	佢而家体落似只鸭。 
Are you looking for work?	你系稳工吗？ 
My father walks.	我阿爸行路。 
Hopefully, we'll enjoy our China trip.	希望我地会钟意我地的中国之旅。 
Why don't you go home?	你做咩唔返屋企呀？ 
I'm going to check.	我去查一下。 
Tom's uncle keeps a lot of sheep.	阿Tom的阿叔养左好多羊。 
I'll treat you.	我请你。 
Could you take this, please?	你可唔可以罗住尼个吗？ 
He arrived after I had left.	我走后佢至到。 
I need someone to talk with.	我需要一个可以倾诉的人。 
Skip it.	跳过佢。 
Would you like some salad?	你想要D沙律吗？ 
I sometimes watch TV.	我有时体电视。 
I'm full.	我饱左。 
He is a learned man.	佢系一个有料的人。 
I was very busy last week.	上周我好忙。 
I will wait.	我会等。 
It's too dark to play baseball now.	而家太黑，唔打棒球。 
Children like fruit juice.	仔们钟意果汁。 
She wouldn't let up until I agreed to go to the movies with her.	直到我同意同佢一齐去体电影，佢先松懈落黎。 
He asked me a question.	佢问左我一个问题。 
Tom bought a mobile phone.	汤姆买左一部手机。 
I hope people are satisfied.	希望大家满意。 
My father retired at the age of 65.	我阿爸65岁退休了。 
The poor people were at the mercy of the cruel dictator.	穷人由残暴的独裁者摆布。 
It's clear that there's a rather strong disagreement between the two.	好明显，两者之间有相当大分歧。 
That's no big deal.	甘冇乜大得的。 
What she said did not make sense.	佢话冇道理。 
He is good at playing tennis.	佢擅长打网球。 
I recognized some of the tunes that Tom played.	我听出左阿Tom演奏的一的曲。 
I lived in Japan three years ago.	三年前我系日本。 
Yesterday I spent the whole day working.	寻日我做左成日。 
It's not something anyone can do.	尼个唔系任何人都可以做到的。 
Tom doesn't have a fever.	阿Tom冇发烧。 
Will he pass the examination? "I am afraid not."	佢通过考试啊？ “体怕唔得。” 
I'd like a glass of water, please.	我想要一杯水。 
They fell into the conversation immediately.	佢地即刻开始交谈。 
What did you do last night?	你寻晚做左咩？ 
He knows how to swim.	佢会游水。 
They got married and settled near Boston.	佢地结婚并系波士顿附近定居。 
I've heard that name somewhere before.	我以前系咩地方听过尼个名。 
I'll be in my office from ten tomorrow.	听日十点起我就系办公室。 
Does he go to school on foot or by bicycle?	佢系行返学定踩单车翻学？ 
I haven't started anything yet.	我仲未开始任何野。 
He often takes me for a drive.	佢成日带我去游车河。 
How much money do you have?	你有几多钱？ 
You were at my wedding.	你离我婚礼。 
There is a good chance that gasoline prices will go up.	电油价钱好有可能会上涨。 
My plan is to buy a car.	我个计划系买架车。 
He is a famous baseball player.	佢系一个出名的棒球运动员。 
He told me to wash my face.	佢叫我洗面啝。 
Thank you for your invitation.	多谢你的邀请。 
He went to New York on Monday.	佢星期一去纽约呀。 
Be quiet, or the baby will wake up.	安静的，唔系宝宝会醒的。 
English is easy to learn.	英文好易学。 
I just wish we could leave this horrible place.	我只系希望我地可唔可以离开尼个可怕的地方。 
I have absolute trust in you.	我绝对信任你。 
She couldn't answer the question.	佢唔答尼个问题。 
I sometimes still think about her.	我有时仲会想起佢。 
He has been very busy this week.	尼个礼拜佢一直都好忙。 
Everybody is immune to smallpox nowadays.	而家个个都对天花免疫。 
We should call the police.	我地应该报警。 
Your proposal is worthy of being considered.	你个建议值得考虑。 
She looks unhappy.	佢好似唔开心。 
The taxi picked up two passengers.	的士车左两名乘客。 
I've always wanted to climb Mt. Fuji.	我一直想去行山。 富士。 
They greeted me with a smile.	佢笑笑口甘迎接我。 
My father has a restaurant.	我阿爸有一间餐厅。 
I don't expect anything from you.	我对你冇咩期望。 
He has been to Hokkaido.	佢去左北海道。 
Tom gave me a pen.	阿Tom比左我一支钢笔。 
I go to church every day.	我每日都去教堂。 
She's dieting.	佢系节食。 
He likes watching TV.	佢钟意体电视。 
Tom should've already discussed that with you.	阿Tom应该已经同你倾过啦。 
I've finished reading the book.	我已经读完尼本书。 
Our school's principal is very old.	我地学校校长年纪好大。 
You'll get used to it.	你会习惯的。 
Tom's house has three bedrooms.	阿Tom的屋有三间卧室。 
He's a tall boy.	佢系一个高佬男仔。 
I can't believe you are eating something the doctor has told you repeatedly you shouldn't eat.	我唔敢相信你系食医生反复话比你听唔应该食的野。 
You don't need to work on Sundays.	星期日你唔使做野。 
Don't throw a stone at the dog.	唔好同狗掟石。 
He makes the most of his opportunities.	佢充分利用佢的机会。 
Black suits you.	黑色啱你。 
Give me something to write with.	比我的可以写字的野。 
They must have made a mistake.	佢地一定系摆乌龙啦。 
Would you like to drink anything?	你想饮的咩呀？ 
How much sugar do you use?	你用左几多糖？ 
She showed the visitor her baby.	佢比来访者体下佢个仔。 
You have to be patient.	你要有好有耐性。 
Could I borrow a pencil?	我可唔可以借支铅笔呀？ 
All plants need water and light.	所有的植物都要水同光。 
One of your buttons has come off.	你一粒钮甩左。 
You know too much.	你知太多啦。 
We didn't know what to do next.	我地唔知下一步要做的咩。 
This is not important.	尼唔紧要。 
He died of lung cancer.	佢死于一个肺癌。 
Have you had your eyesight checked recently?	你最近检查过我视线吗？ 
What's the weight of your suitcase?	你公事喼有几重？ 
What happened to you last night?	琴晚你点呀？ 
I don't smoke weed.	我唔食大麻。 
I asked her out on a date.	我约佢出去拍拖。 
I don't know if I'll have time to do it.	我唔知我系有时间做尼件事。 
Excuse me for interrupting you.	对唔住，阻你啦。 
Do you want to be rich?	你想变得有钱吗？ 
It's on the sofa.	系梳化度。 
I knew what Tom was doing.	我知汤姆系度做紧咩。 
I respect the elderly.	我尊重的老人家。 
A bookstore in that location wouldn't make enough money to survive.	果个地方书店赚唔到紧要的钱黎生存。 
I know the problem.	我知道问题所在。 
Where did you see her?	你系边度见过佢？ 
Will you switch seats with me?	你可以同我换个位啊？ 
She has been absent since last Wednesday.	自上周三以黎，佢一直缺席。 
Tom hugged Mary.	阿Tom揽左阿Mary。 
My father made me a delicious lunch.	我老豆比我做左一餐好正的午餐。 
The wind calmed down.	风平静左嘞。 
Be careful not to drive the wrong way on a one-way street.	因住唔好系单行道上开错路。 
A plastic dish will melt on the stove.	胶碟系炉子上会融化。 
It cost him 50 dollars to rent a car in Hawaii.	系夏威夷租车花左佢五十美元。 
You work as hard as he did at your age.	你同佢系你尼个后生果阵一样努力做野。 
The United States is abundant in natural resources.	美国自然资源丰富。 
Please write with a pen.	唔该比墨水笔写字。 
I want Tom to win.	我希望阿Tom赢。 
Many of the immigrants changed their names.	好多移民改左个名。 
French is my mother tongue.	法文系我母语。 
My brother takes care of our dog.	我大佬照顾我地的狗。 
Give some meat to the dog.	比只狗的肉。 
It's a pleasure to have you with us again.	好高兴你再次同我地系埋一齐。 
We generally drink tea after a meal.	我地一般食完饭饮茶。 
I really need a drink now.	我而家真系要饮杯。 
Look at that tall building.	体甘栋高楼。 
He and his sisters are currently living in Tokyo.	佢同佢姊妹们目前系东京。 
I've lost my pen.	我支笔跌左。 
Those are my trousers.	甘我裤。 
Don't be cruel to animals.	唔好对动物阴功。 
Mt. Fuji is Japan's tallest mountain.	富士山系日本最高的山。 
Forewarned is forearmed.	预早警告就系预早武装。 
What prevented you from coming earlier?	系咩阻止都左你早的黎？ 
I have a high fever.	我发高烧啦。 
Our school is near the station.	我地学校系车站附近。 
None of these buses go to Shinjuku.	尼的巴士都唔去新宿。 
I've got things under control.	一切都系我掌控之中。 
It's 3:30.	而家系三点半。 
That child has few friends.	个细路几乎冇朋友。 
Being a good conversationalist does not just mean being a good speaker of English.	成为一个好倾得者不仅仅意味住成为一个好的英语演讲者。 
My parents have gone to the airport to see my uncle off.	我阿爸阿妈去机场比我阿叔送行啦。 
Shortly after the accident, the police came.	事故发生后冇几耐，差佬黎啦。 
Not everything can be bought with money.	唔系所有野都可以得用买到。 
Professional writers do not have a regular income.	职业作家冇入墙收入。 
I saw a strange woman there.	我系果度见到一个生暴的女人。 
You have to speak English here.	你一定要系尼度讲英文。 
What did you major in at college?	你系大学主修咩？ 
Tom probably knew who I was.	阿Tom可能知道我系边个。 
You are her daughters.	你地系个女。 
Stand up.	企起身。 
Classes begin next week.	下个礼拜开始上堂啦。 
I am afraid of death.	我惊死亡。 
Please do not open the windows.	请唔好打开窗。 
Write it down before you forget it.	系你唔记得之前佢写落黎。 
I have not heard from her recently.	我最近冇佢消息。 
Don't open that.	唔好打开个。 
Rice is sold by the kilogram.	大米按公斤出售。 
I know what you did.	我知你做左咩。 
I'd like seats on the first floor.	我想要一楼的座位。 
Please send me a letter.	唔该比我寄封信。 
We go to the same school.	我地上同一间学校。 
I asked for a table over there.	我系果边要左一张枱。 
She stayed in the house all day.	佢成日屈系屋企。 
What time do you leave for school?	你几点启程去翻学？ 
Tom didn't understand what the teacher said.	阿Tom听唔明老师讲的说话。 
What souvenir do you think she would like most?	你话佢最中意咩纪念品？ 
She has an eye for beauty.	佢对靓好有眼光。 
They were carelessly unaware of the danger.	佢地漫不经心甘冇意识到危险。 
Let me know when you need me again.	当你再次要我的时候，等我知。 
I don't want to be friends with you.	我唔想同你做朋友。 
I'm old enough to live by myself.	我已经大到可以一个人生活。 
Does the letter need to be written in English?	尼封信要用英文写啊？ 
I should be happy.	我好开心。 
Rome wasn't built in a day.	罗马唔系一日建成的。 
A little walk will give you a good appetite for breakfast.	散步会比你对早餐胃口大开。 
You should talk directly to Tom.	你应该直接同阿Tom倾。 
Are you able to play organ?	你会弹理风琴吗？
